R   900     600
NO        ./texture/wstone.xpm
SO  ./texture/wstone.xpm
WE  ./texture/wstone.xpm
EA  ./texture/wstone.xpm
S  ./texture/sprite.xpm
F  0  , 51,0
C  153 , 204  ,  255  

 1111111111111    
100000000000001
102000W1000001
 111111111111