R 202 202
NO ./texture/1.xpm
SO ./texture/2.xpm
WE ./texture/3.xpm
EA ./texture/4.xpm
S ./texture/sprite.xpm
F 150,050,50
C 50,050,150

1111111111
1000001001
10E0000001
1000001011
1110111001
1110000001
1000011011
1021111011
1001000001
1111111111