R   1200 800
NO  ./texture/wall_blocks.xpm
SO  ./texture/wall_wood.xpm
WE  ./texture/wall_bricks.xpm
EA  ./texture/wall_stone.xpm
S  ./texture/golden_key.xpm

F  0,51,0
C  00,33,66  

11111111111111111111
10000010000000000021
10010010111100111111
10010000100000120001
10011111111111111101
10012000100000000001
10011101110111110001
10000000000100210001
11110000000100000001
10011111111111100001
10000010000100100001
11010111000000100001
10010000010101110111
10011101110101000001
10000100100100001011
11100100100100111001
10001110001100121101
1N001000000100100001
11111111111111111111
