R 900 600
NO ./texture/wstone.xpm
SO ./texture/wstone.xpm
WE ./texture/wstone.xpm
EA ./texture/wstone.xpm
S ./texture/sprite.xpm
F 0,51,0
C 153,204,255

        1111111111111111111111111
        1000000000110000000000001
        1011000001110002002002001
        1001000000000000000000001
111111111011000001110000000000001
100000000011000010110111111111111
11110111111111011100000010000001
1111011111111101110101000000111
11000000110101011100000010001
10002001000000001100000010001
 100N000000200200001010010001
1100000111010101111101111000111
11110111 1110101 101111010001
11111111 1111111 111111111111