        1111111111111111111111111
        1000000000110000000000001
        1011000001110002002002001
        10010E0000000000000000001
111111111011000001110000000000001
100000000011000010110111111111111
11110111111111011100000010000001
1111011111111101110101000000111
11000000110101011100000010001
10002001000000001100000010001
 1000000000200200001010010001
11000001111101011111011110001
11110000000000000001111010001
11111111111111111111111111111