R   1000 600
NO  ./texture/stone1.xpm
SO  ./texture/stone4.xpm
WE  ./texture/stone8.xpm
EA  ./texture/stone3.xpm
S  ./texture/star_coin.xpm

F  28,112,28
C  51,135,219

111111111111111
102100001000021
100111011101111
100000000000001
111100000001001
100110111111101
100000100001001
110101110000001
100100000101011
100111011101011
100001001001001
111021001001101
100011100011001
1E0012000001201
111111111111111
