R 900 680
NO ./texture/1.xpm
SO ./texture/2.xpm
WE ./texture/3.xpm
EA ./texture/4.xpm
S ./texture/sprite.xpm
F 150,050,50
C 50,050,150

11111111111
10000000S01
10011110001
1001  12001
10011110001
10200000001
11111111111